111111111111111111111111111111111111111111111111111111111111111111
1E0000000000000C00000C00000000000000000000000000000000000000000001
10100101001000001010010000000101000000000100000000000C00000000C001
10100100101010100010010000000101000000000C0000000C000000C000000001
1P0000000C00C0000000000000000000C00000000010000000000100000000C001
100000000C00C0000000000000000000C00000000010000000000100000000C001
100000000C00C0000000000000000000C00000000010000000000100000000C001
100000000C00C0000000000000000000C00000000010000000000100000000C001
100000000C00C0000000000000000000C00000000010000000000100000000C001
100000000C00C0000000000000000000C00000000010000000000100000000C001
100000000C00C0000000000000000000C00000000010000000000100000000C001
100000000C00C0000000000000000000C00000000010000000000100000000C001
100000000C00C0000000000000000000C00000000010000000000100000000C001
100000000C00C0000000000000000000C00000000010000000000100000000C001
111111111111111111111111111111111111111111111111111111111111111111