11111111111111111111111111
10000000000000000000000001
100E0000000100000111000001
1000CC00001100001001000001
1000M000010100000001000001
10000000111100000010000001
1P000000000100000111100001
10000000000000000000000001
11111111111111111111111111
