11111111111111111111111111
1E000000000000000000000001
10000000000000000P00000001
10000000000000000000000001
11111111111111111111111111
