11111111111111111111111111
1C0000000E0000000000000001
10000000000000000000000000
1000000000P000000000000001
11111111111111111111111111