1111111111111111111111111111111111111111111111
1PCE000000000000000000000000000000000000000001
1000000000000000000000000000000000000000000001
1000000000000000000000000000000000000000000001
1000000000000000011111110111111111111111000001
1000000000000011111111000111100011111111000001
1000000000001111111000000101000011111111000001
1000000001111111100000000100000011111110000001
1000000111111100000000000000011111111000000001
1000001111110000000000000001111111000000000001
1000001111000000000000000111111100000000000001
1000001111111111111111110111111100000111000001
1000001111111111111111110111111100011111000001
1000001111111111111111110111111101111111000001
1000000000000000011111110111111111111111000001
1000000000000000011111110000000000000000000001
1000000000000000011111110000000000000000000001
1000000000000000000000000000000000000000000001
1000000000000000000000000000000000000000000001
1000000000000000000000000000000000000000000001
1111111111111111111111111111111111111111111111