11111111111111111111111111111111111111111111111111111111111111111
1PCE0000000000000000000000000000000000000000000000000000000000001
10000000000000000000000CCC00000000000CCCCCCCCCC000000000000000001
1000000000000000000000CCC00000000000CCCCCCCCCCCC00000000000000001
100000000000000000000CCC00000000000CCC0000000CCCC0000000000000001
10000000000000000000CCC00000000000CCC0000000000CCC000000000000001
1000000000000000000CCC00000000000CCC000000000000CCC00000000000001
100000000000000000CCC00000000000CCC00000000000000CCC0000000000001
10000000000000000CCC00000000000CCC0000000000000000CCC000000000001
1000000000000000CCC0000000000000000000000000000000CCC000000000001
100000000000000CCC00000000000000000000000000000000CCC000000000001
10000000000000CCC000000000000000000000000000000000CCC000000000001
1000000000000CCC0000000000000000000000000000000000CCC000000000001
100000000000CCC00000000000000000000000000000000000CCC000000000001
10000000000CCC000000000000000000000000000000000000CCC000000000001
1000000000CCC000000000000000000000000000000000000CCC0000000000001
100000000CCC000000000000000000000000000000000000CCC00000000000001
100000000CCCCCCCCCCCCCCCCCC00000000000000000000CCC000000000000001
100000000CCCCCCCCCCCCCCCCCC0000000000000000000CCC0000000000000001
1000000000000000000000000CC000000000000000000CCC00000000000000001
1000000000000000000000000CC00000000000000000CCC000000000000000001
1000000000000000000000000CC0000000000000000CCC0000000000000000001
1000000000000000000000000CC000000000000000CCC00000000000000000001
1000000000000000000000000CC00000000000000CCC000000000000000000001
1000000000000000000000000CC0000000000000CCC0000000000000000000001
1000000000000000000000000CC000000000000CCC00000000000000000000001
1000000000000000000000000CC00000000000CCC000000000000000000000001
1000000000000000000000000CC0000000000CCCCCCCCCCCCCCCCCC0000000001
1000000000000000000000000CC000000000CCCCCCCCCCCCCCCCCCC0000000001
10000000000000000000000000000000000000000000000000000000000000001
10000000000000000000000000000000000000000000000000000000000000001
11111111111111111111111111111111111111111111111111111111111111111