1111111111111111111111
1EC0000000000000000001
10000P0000000000000001
1000000000000000000001
10000M0000000000000001
1000000000000000000001
1111111111111111111111