11111111111111111111111111111111111111111111111111111111111111111
1E000000C000000P1000000000000000100000000000000010000000000000001
10000100000111001000010000011100100001000001110010000100000111001
10001100001001001000110000100100100011000010010010001100001001001
10010100000001001001010000000100100101000000010010010100000001001
10111100000010001011110000001000101111000000100010111100000010001
10000100000111101000010000011110100001000001111010000100000111101
10000000M00000001000000000000000100000000000000010000000000000001
11111111111111111111111111111111111111111111111111111111111111111
10000000000000001000000000000000100000000000000010000000000000001
10000100000111001000010000011100100001000001110010000100000111001
10001100001001001000110000100100100011000010010010001100001001001
10010100000001001001010000000100100101000000010010010100000001001
10111100000010001011110000001000101111000000100010111100000010001
10000100000111101000010000011110100001000001111010000100000111101
10000000000000001000000000000000100000000000000010000000000000001
11111111111111111111111111111111111111111111111111111111111111111
10000000000000001000000000000000100000000000000010000000000000001
10000100000111001000010000011100100001000001110010000100000111001
10001100001001001000110000100100100011000010010010001100001001001
10010100000001001001010000000100100101000000010010010100000001001
10111100000010001011110000001000101111000000100010111100000010001
10000100000111101000010000011110100001000001111010000100000111101
10000000000000001000000000000000100000000000000010000000000000001
11111111111111111111111111111111111111111111111111111111111111111
10000000000000001000000000000000100000000000000010000000000000001
10000100000111001000010000011100100001000001110010000100000111001
10001100001001001000110000100100100011000010010010001100001001001
10010100000001001001010000000100100101000000010010010100000001001
10111100000010001011110000001000101111000000100010111100000010001
10000100000111101000010000011110100001000001111010000100000111101
10000000000000001000000000000000100000000000000010000000000000001
11111111111111111111111111111111111111111111111111111111111111111