11111111111111111111111111
1C10000000000000000000M001
11000000000000000E00000001
1000000000P000000000000001
11111111111111111111111111